H H H H H H H H H H H H H H H H H H H H H H
H o · · · H o · · · · · · · · o H · · · o H
H · H H · H · H H H H H H H H · H · H H · H
H · H · · · · · · · · · · · · · · · · H · H
H · H · H H · H H H - - H H H · H H · H · H
H · H · · · · H - - - - - - H · · · · H · H
H · · · H H · H - - - - - - H · H H · · · H
H · H · · · · H - - - - - - H · · · · H · H
H · H · H H · H H H H H H H H · H H · H · H
H · H · · · · · · · · · · · · · · · · H · H
H · H H · H · H H H H H H H H · H · H H · H
H o · · · H o · · · · · · · · o H · · · o H
H H H H H H H H H H H H H H H H H H H H H H
